S,P,P,P,P,P,P,P,P,P
P,T,T,P,T,E,P,E,E,P
P,T,T,P,E,E,P,E,E,P
P,T,E,P,E,E,P,E,E,P
P,T,E,P,E,E,P,E,E,P
P,T,E,P,E,E,P,E,E,P
P,E,E,P,E,E,P,E,E,P
P,E,E,P,E,E,P,E,E,P
P,E,E,P,E,E,P,E,E,P
P,E,E,P,E,E,P,E,E,P
P,P,P,P,P,P,P,P,P,P
